1100000000000000000000000000000000000000
1111010111011101111101110111011101111111
0101010100000100010000010001000100010101
0101011111011111111111010111111111110101
0100000100010100010001010100000000000100
0101011101010111010111111111010111011101
0101010101010100000101000000010001010001
0111110111010101110101110111110111110101
0001010000000101010001000100010101000101
0101010111010101010111110111011101110111
0101010001010000010100010100000100000001
0111011111111111010101110101111111011111
0100000000010100010100010000000100010100
0111110111110111011111011111110111110101
0100000100010000000101010100000101010001
0111011101010101011101010101110101010111
0100010101000101010101000100010100010100
0101110101111111010101011101011111010111
0101000100010001000100000101000001000100
0101010111110111110101110101110111110101
0100010100010001000001000101000000010101
0111110101110111010111110101011111110111
0001010000000001010100010101000100000001
0101010111111111110101011111110101011111
0101000000000000000101010001000001010001
0111111111010101110111010101111101110101
0000000100010100010001010100010101010100
0111110111011111011111010101110111010111
0101000100010000000100010101010000010100
0101110101011101011111011101011101111111
0001010101010001010000010000000001000000
0101011101110111010101111101010101111111
0100010101000101000101000001010100000000
0111110111010101111101010111010111011111
0101010001010001010001010101010001000100
0101010111011111010101111101110111011111
0001010001000101010101000100010001000100
0111010111111101011101011101010111111101
0101000001000101000000010001000100000101
0101011111110101111101011111111101011111
0101000101010001000001000101000001000000
0101010101011101111111111101111111111111
0100010000010101000100000001010000000100
0111010111110101011101110111011101111111
0100010000000100000101000100010000010000
0101111101011111010111011101110111111111
0100010001010000010100010001000101000100
0111011101111101011101111101011101110101
0100010101010001010001000100000000010001
0111010111011101111101110101111111111111
