110000000000000000000000000000
110101011101110111011111011111
010101010001000100010000010100
011111111111110111110101110101
010000000100000101000101000001
011101111101010101111111110111
000101000101010100000101010100
010101110111110101110101010111
010001010000000100010000010100
010111010111011111011101011101
010100010100000101010001010001
011101111111111101111101111111
010000000100000100000100000001
011101010101011101111111010111
010001010001000000010000010100
011111111101111111011111110111
000001010000000101000100010000
011101010101110101010111010111
010101000100010101010100010101
010111111101010101111111011101
010001000101010000010100000000
010111011111111111010111011101
010001010000010101000100010101
010111010111010101110101010101
000001000101000101010001010001
011101011101010101011111010111
010000000001010000010101010001
011111010111111101110101111111
010101010101000001000001000000
010101110101011111110111111101
010001010100010100000000010001
010111010101110111111101011101
000001000101000000010101000001
010101110101111101010101110111
010101000101000001010001000001
011111011101110111110101011111
010000000100000101000101000100
011101110101111101111111011111
010001010101000100000000010001
011111011111011111111111111101